############
#        O #
#   P  #####
#          #
######     #
#  O #     #
#       XX #
#       #  #
############
